Инструкции: 

Грамматические признаки из разных категорий пишутся через запятую без пробелов, а грамматические признаки одной категории пишутся в круглых скобках через вертикальную черту.
Пример запроса с грамматическими признаками для лексемы: дядя sg,(nom|gen)

Список грамматических признаков по категориям:

Часть речи:
S — существительное (яблоня, лошадь)
A — прилагательное (таинственный, морской)
NUM — числительное (четыре, много)
ANUM — числительное-прилагательное (один, седьмой)
V — глагол (пользоваться, обрабатывать)
ADV — наречие (сгоряча, очень)
PRAEDIC — предикатив (жаль, хорошо)
PARENTH — вводное слово (кстати, по-моему)
SPRO — местоимение-существительное (она, что)
APRO — местоимение-прилагательное (который, твой)
ADVPRO — местоименное наречие (где, вот)
PRAEDICPRO — местоимение-предикатив (некого, нечего)
PR — предлог (под, напротив)
CONJ — союз (и, чтобы)
PART — частица (бы, же)
INTJ — междометие (увы, батюшки)

Род:
m — мужской род (работник, стол)
f — женский род (работница, табуретка)
n — средний род (животное, озеро)

Одушевленность:
anim — одушевленность (человек, утопленник)
inan — неодушевленность (рука, культура)

Число:
sg — единственное число (яблоко, гордость)
pl — множественное число (яблоки, ножницы)

Падеж:
nom — именительный падеж (голова, который)
gen — родительный падеж (головы, которого)
dat — дательный падеж (голове, которому)
dat2 — дистрибутивный дательный ([по] многу, нескольку)
acc — винительный падеж (голову,  который/которого)
ins — творительный падеж (головой, которым)
loc — предложный падеж ([о] голове, котором)
gen2 — второй родительный падеж (чашка чаю)
loc2 — второй предложный падеж (в лесу, на оси́)
adnum — счётная форма (два часа́, три шара́)

Степень/Краткость:
comp — сравнительная степень (глубже)
comp2 — форма «по+сравнительная степень» (поглубже)
supr — превосходная степень (глубочайший)
brev — краткая форма (высок, нежна)
plen — полная форма (высокий, нежная)

Вид:
pf — совершенный вид (пошёл, встречу)
ipf — несовершенный вид (ходил, встречаю)

Залог:
act — действительный залог (разрушил, разрушивший)
pass — страдательный залог (только у причастий: разрушаемый, разрушенный)
med — медиальный, или средний залог (глагольные формы на -ся: разрушился и т.п.)

Наклонение/Форма:
indic — изъявительное наклонение (украшаю, украшал, украшу)
imper — повелительное наклонение (украшай, украшайте)
imper2 — форма повелительного наклонения 1 л. мн. ч. на -те (идемте)
inf — инфинитив (украшать)
partcp — причастие (украшенный)
ger — деепричастие (украшая)

Время:
praet — прошедшее время (украшали, украшавший, украсив)
praes — настоящее время (украшаем, украшающий, украшая)
fut — будущее время (украсим)

Лицо:
1p — первое лицо (украшаю)
2p — второе лицо (украшаешь)
3p — третье лицо (украшает)

Имена собственные:
persn — личное имя (Иван, Дарья)
patrn — отчество (Иванович, Павловна)
famn — фамилия (Николаев, Волконская)

Прочее:
topon - топоним (Крым, Москва)